25 25 25 25 25 25 25 23  1  1 22 25 25 25 25 25 25 25 23  1  1  1 22 25 25 25 25 25 25 25 25 25 23  1  1 25 25 25 25 25 25 25 25 25
25 25 25 25 25 25 25 23  1  1 22 25 25 25 25 25 25 25 23  1  1  1 22 25 25 25 25 25 25 25 25 25 23  1  1 25 25 25 25 25 25 25 25 25
25 25 25 25 25 25 25 23  1  1 22 25 25 25 25 25 25 25 23  1  1  1 22 25 25 25 25 25 25 25 25 25 23  1  1 25 25 25 25 25 25 25 25 25
25 25 25 25 25 25 25 23  1  1 22 25 25 25 25 25 25 25 23  1  1  1 22 25 25 25 25 25 25 25 25 25 23  1  1 25 25 25 25 25 25 25 25 25
25 25 25 25 25 25 25 23  1  1 22 25 25 25 25 25 25 25 23  1  1  1 22 25 25 25 25 25 25 25 25 25 23  1  1 25 25 25 25 25 25 25 25 25
25 25 25 25 25 25 25 23  1  1 22 25 25 25 25 25 25 25 23  1  1  1 22 25 25 25 25 25 25 25 25 25 23  1  1 25 25 25 25 25 25 25 25 25
25 25 25 25 25 25 25 23  1  1 22 25 25 25 25 25 25 25 23  1  1  1 22 25 25 25 25 25 25 25 25 25 23  1  1 25 25 25 25 25 25 25 25 25
24 24 24 24 24 24 24 21  1  1 20 24 24 24 24 24 24 24 21  1  1  1 20 24 24 24 24 24 24 24 24 24 21  1  1 20 24 24 24 24 24 24 24 24
1  1  1  1  1  1  1  1  1  1  1  1  1  1  1  1  1  1  1  1  1  1  1  1  1  1  1  1  1  1  1  1  1  1  1  1  1  1  1  1  1  1  1  1
1  1  1  1  1  1  1  1  1  1  1  1  1  1  1  1  1  1  1  1  1  1  1  1  1  1  1  1  1  1  1  1  1  1  1  1  1  1  1  1  1  1  1  1
1  1  1  1  1  1  1  1  1  1  1  1  1  1  1  1  1  1  1  1  1  1  1  1  1  1  1  1  1  1  1  1  1  1  1  1  1  1  1  1  1  1  1  1
1  1  1  1  1  1  1  1  1  1  1  1  1  1  1  1  1  1 11 15 15 15 12  1  1  1  1  1  1  1  1  1  1  1  1  1  1  1  1  1  1  1  1  1
1  1  1  1  1  1  1  1  1  1  1  1  1  1  1  1  1  1 17 19 19 19 18  1  1  1  1  1  1  1  1  1  1  1  1  1  1  1  1  1  1  1  1  1
1  1  1  1  1  1  1  1  1  1  1  1  1  1  1  1  1  1 17 19 19 19 18  1  1  1  1  1  1  1  1  1  1  1  1  1  1  1  1  1  1  1  1  1
1  1  1  1  1  1  1  1  1  1  1  1  1  1  1  1  1  1 17 19 19 19 18  1  1  1  1  1  1  1  1  1  1  1  1  1  1  1  1  1  1  1  1  1
1  1  1  1  1  1  1  1  1  1  1  1  1  1  1  1  1  1 13 16 16 16 14  1  1  1  1  1  1  1  1  1  1  1  1  1  1  1  1  1  1  1  1  1
1  1  1  1  1  1  1  1  1  1  1  1  1  1  1  1  1  1  1  1  1  1  1  1  1  1  1  1  1  1  1  1  1  1  1  1  1  1  1  1  1  1  1  1
1  1  1  1  1  1  1  1  1  1  1  1  1  1  1  1  1  1  1  1  1  1  1  1  1  1  1  1  1  1  1  1  1  1  1  1  1  1  1  1  1  1  1  1
1  1  1  1  1  1  1  1  1  1  1  1  1  1  1  1  1  1  1  1  1  1  1  1  1  1  1  1  1  1  1  1  1  1  1  1  1  1  1  1  1  1  1  1
25 25 25 25 25 25 25 23  1  1 22 25 25 25 25 25 25 25 23  1  1  1 22 25 25 25 25 25 25 25 25 25 23  1  1 22 25 25 25 25 25 25 25 25
25 25 25 25 25 25 25 23  1  1 22 25 25 25 25 25 25 25 23  1  1  1 22 25 25 25 25 25 25 25 25 25 23  1  1 22 25 25 25 25 25 25 25 25
25 25 25 25 25 25 25 23  1  1 22 25 25 25 25 25 25 25 23  1  1  1 22 25 25 25 25 25 25 25 25 25 23  1  1 22 25 25 25 25 25 25 25 25
25 25 25 25 25 25 25 23  1  1 22 25 25 25 25 25 25 25 23  1  1  1 22 25 25 25 25 25 25 25 25 25 23  1  1 22 25 25 25 25 25 25 25 25
25 25 25 25 25 25 25 23  1  1 22 25 25 25 25 25 25 25 23  1  1  1 22 25 25 25 25 25 25 25 25 25 23  1  1 22 25 25 25 25 25 25 25 25
25 25 25 25 25 25 25 23  1  1 22 25 25 25 25 25 25 25 23  1  1  1 22 25 25 25 25 25 25 25 25 25 23  1  1 22 25 25 25 25 25 25 25 25
25 25 25 25 25 25 25 23  1  1 22 25 25 25 25 25 25 25 23  1  1  1 22 25 25 25 25 25 25 25 25 25 23  1  1 22 25 25 25 25 25 25 25 25
25 25 25 25 25 25 25 23  1  1 22 25 25 25 25 25 25 25 23  1  1  1 22 25 25 25 25 25 25 25 25 25 23  1  1 22 25 25 25 25 25 25 25 25
